------------------------------
-h----------------------------
-+----------------------------
-+----------------------------
-+----------------------------
-+++++------------------------
-++--++++---------------------
-+++++++++--------------------
-++---------------------------
-++++++-----------------------
---++------+++p+++------------
-++-+++-+---++--+++++++++++++-
-+++-+++++++++++++---++++---+-
---++------------------+r+++t-
------------------------------

