------------------------------
-+++++++++++++++++++++++++++++
-+++++++++++++++++++++++++++++
-++++++++++++++++++++++++++-+-
-++++++++++++++++++++++++++++-
-++++++++++++++++++++++++++++-
-++--++++++++++++++++++++++++-
-+++++++++--------++------+++-
-++----++---------------------
-+++++++++++++++++++++---++++-
---++------++++++++++++++++++-
-++-+++-+---++--+++++++++++++-
-+++++++++++++++++---++++---+-
---+r------------------+++++t-
------------------------------

