------------------------------
-h+++++-----------------+-----
-+++-++++++++++++++++++++++++-
-+++------+++++++-------+++-+-
-++++-------------------+++++-
-+++++++---+++++----------+++-
-++--++++-------++++------+++-
-+++++++++--------++------+++-
-++----++++++++++++++++++++++-
-++++++-----------++++---++++-
---++------+++++++----------p-
-++-+++-+---++--+++m+++++++++-
-+++++++++++++++++---++++---+-
---++------------------+++++t-
------------------------------

